##################
#rb #            #
#py #  ###  ###  #
##  #            #
#    .  .  .     #
#  # .#  # .#  # #
#  # .#  # .#  # #
#  #  #  # .#  # #
#  #  #  # .#  # #
#  #  #  # .#  # #
#  #  #  # .#  # #
#  #  #  # .#  # #
#  #  #  # .#  # #
#  #  #  # .#  # #
#  #  #  # .#  # #
#          .     #
#          .....P#
##################
