##################
#rb #            #
#py #  ###  ###  #
##  #            #
#    .  .  .     #
#  #  #  # .#  # #
#  #  #  # .#  # #
#  #  #  # .#  # #
#  #  #  # .#  # #
#  #  #  # .#  # #
#  #  #  # .#  # #
#  #  #  # .#  # #
#  #  #  # .#  # #
#  #  #  # .#  # #
#  #  #  # .#  # #
#          .     #
#          .....P#
##################
